TILEMAP
64 96 							-- Size of tile map in tiles
32 32							-- Tile size & block size
images/Tilesheetgameboy.png 	-- Tilesheet
2 32							-- Number of tiles in tilesheet
HHHHHHHHHHHHHHHHHHHHHDHHHHHHHHHHHHHHHHHHHHHHHHHHHHHHHHHHHHHHHHHH
HHHHHHHHHHHHHHHHHHHHHDHHHHHHHHHHHHHHHHHHHHHHHHHHHHHHHHHHHHHHHHHH
HHHHHHHHHHHHHHHHHHHHHHHHHHHHHHHHHHHHHHHHHHHHHHHHHHHHHHHHHHHHHHHH
HHHHHHHHHHHHHHHHHHHHHHHHHHHHHHHHHHHHHHHHHHHHHHHHHHHHHHHHHHEHHHHH
HHHHHCHHHHHHHHHHHHHHHHHHHHHHHHHHHHHHHHHHHHHHHHHHHHHHHHHHHHHHHHHH
HHHHHHHHHHHHHHHHHHHHHHHHHHHHHHHHHDHHHHHHHHHHHHHHHHHHHHHHHHHHHHHH
HHHHHHHHHHHHHEHHHHHHHHHHHHHHHHHHHHHHHEHHHHHHHHHHHHHHHHHHHHHHHHHH
HHHHHHHHHHHHHHDHHHDHHHHCHHHHHHHHHHHHHHHHHHHHHHCHHHHHHHHHHHHHHHHH
HHHHHHHHHHHHHHHHHHHHHHHHDHHHHHHHHHHHHHHHHHHHHHHHHHHHEHHHHHHHHHHH
HHHHHHHHHDHHHHHHHHHHHHHHHHHHHHHHHHHHHHHHHHHHHHHHHHHHHHHHHHHHHHHH
HHHHHHHHHHHHHHHHHHHHHHHHHHHHHHHHHHHHHHHHHHHHHHHDHHHHHHHHHHHHHHHH
HHHHHHHHHHHHHHHHHHHHHHHHHHHHHHHHHHHHHHHHHHHHHHHHHHHHHHHHHHHHHHHH
HHHHHHHHHHHHHHHHEHHHHHHHHHHCHHHHHHHHHHHHHHHHHHHHHHHHHHHHHHHCHHHH
HHHHCHHHHDHHHHHHHHHHHHDHHHHHHHHHHHHHHHHHHHHHHHHHHHHHHHHHHHHHHHHH
HHHHHHHHHHHHHHHHHHHHHHHHHHHHHHHHHHHHHHHHHDHHHHHHHHHHHHHHHHHHHHHH
YYYYYYYYYYYYYYYYYYYYYYYYYYYYYYYYYYYYYYYYYYYYYYYYYYYYYYYYYYYYYYMW
YYYYYYYYYYYYYYYYYYYYYYYYYYYYYYYYYYYYYYYYYYYYYYYYYYYYYYYYYYYYA:OW
YAAAAAAA<=>HHHH;AAAAA:HHHHHH7AAB@HHHHHHHHH9AAABAAAA:HHHHHHHHHHOW
Y9AAAAAAAAA<H;AAABA:HHHHHHH=AAAA@HHHHHHHHHHH9AAAAAAHHHHHHHHHHHOW
YHHABAAAAAAAQRAAHHHHHHHHHHH?AAAA@HHHHHHHHHHHH7AAAA:HHHHHHHHHHHOW
YHH?AA:HHHH9SYYYYYTHHHHHHHH?AAAAA<HHHHHHHHHHH7AAB@HHHHHHHHHHHHOW
YHHAA@HHHHHHWVAAA:HHHHHHHHHAAAAAA@HHHHHHHHHH=AAAA@HHHHHHHHHHHHOW
YHH9A@HHHHHHWVA:HHHHHHHHHH;AAAAAA@HHHHHHHHHH?AAAA@HHHHHHHHHHHHOW
YHHHAA<HQRH;WVAHHHHHHHHHHH?AAABAA@HHHHHHHHHH?AAAAA<HHHHHHHHHHHOW
YHHHAAAAST;AWVAHHHHHHHHHHH?AAAAAAA<HHHHHHHHHAAAAAA@HHHHHHHHHHHN_
YHHHAAAAWVAAWVAHHHHHHHHHHH?AAAAAAAA>HHHHHHH;AAAAAA@HHHHHHHHHHH_k
YHHHAABAWVABWV:HHHHHHHHHHH?BAAAAAAA@HHHHHHH?AAABAA@HHHHHHHHHHHcH
YHH;QRAAWVAAWVHHHHHHHHHHHHAAAAAAAAA@HHHHHHH?AAAAAAA<HHHHHHHH_\kH
YHH?STAAWV9AWVHHHHHHHHHHH_\][\^][\`@HHHHHH;AAAAAAAAA>HHHHH_[kHHH
YHH?STA:WVHHWVA4HHHHHHHHHaHHHHHHHHdA<HHHHHAABAAAAAAA@HHHHHaHHHHH
YH;AWVGGWVGGHHGGGG_[[[\[]kHHHHHHHHl^\[`HH;AAAAAAAAAAAHHH_]kHHHHH
YMWYYYYYYYYYYYYYV_kHHHHHHHHHHHHHHHHHHHl[`WYYYYYYYYYYYYV_kHHHHHHH
YOWYYYYYYYYYYYYYVemHHHHHHHHHHHHHHHHHHHnjfWYYYYYYYYYYYYVeijmHHHHH
YOHH9AAABAAAAA:HHHejgmHHHHHHHHHHHHnjhifHHHH9AAABAAAA:HHHHHcHHHHH
YOHHHH9AAAAA:HHHHHHHHeghijmHHHHHngfHHHHHHHHHH9AAAAAAHHHHHHehmHHH
YOHHHHH7AAA6HHHHHHHHHHHHHHeighjgfHHHHHHHHHHHHH7AAAA:HHHHHHHHaHHH
YOHHHHH7AAB6HHHHHHHHHHHHHHHHHOHHHHHHHHHHHHHHHH7AAB@HHHHHHHHHcHHH
YYYTMHH7AAA6HHHHHHHHHHHHHHHHHOHHHHHHHHHHHHHHH=AAAA@HHHHHHHHHemHH
YA:HOHH7BAA6HHHHHHHHHHHHHHHHHOHHHHHHHHHHHHHHH?AAAA@HHHHHHHHHHemH
Y:HHNHH7AAA6HHHHHHHHHHHHHHHHHOHHHHHHHHHHHHHHH?AAAAA<HHHHHHHHHHcH
YHHHHHH?AAA6HHHHHHHHHHHHHHHHHNHHHHHHHHHHHHHHHAAAAAA@HHHHHHHHHHem
YHHHHH;AAAAA<HHHHHHHHHHHHHHHHHHHHHHHHHHHHHHH;AAAAAA@HHHHHQRHHHHe
YHHHHH?AAAAA@HHHHHHHHHHHHHHHHHHHHHHHHHHHHHHH?AAABAA@HHHHHYVHHHHH
YHHHHH?AABAA@HHHHHHHHHHHHHHHHHHHHHHHHHHHHHHH?AAAAAAA<HHHHYVHHHH;
YHHHH;AAAAAAA<HHHHHHHHHHHHHHHHHHHHHHHHHHHHHH?AAAAAAAA>HHHYQRHHH?
YHHH=AAAAAAAAA>HHHHHHHHHHHHHHHHHHHHHHHHHHHHH?BAAAAAAA@HHHYYTHHHS
YHH;AABAAooooooGGGGGGGGGGGGGGGGGGGGGGGGGGGGGooooooooooGGGYYVHHHW
YYYYYYYYYYYYYYYYYYYYYYYYYYYYYYYYYYYYYYYYYYYYYYYYYYYYYYYYYYYYYVMY
YYYYYYYYYYYYYYYYYYYYYYYYYYYYYYYYYYYYYYYYYYYYYYYYYYYYYYYYYYYYA:OY
VHHHHHHHH9AAABAAYAAAAAAAAAAAAAAAAA:HHHHHHHH9AAAAAAAAAAA:HHHHHHOY
VHHHHHHHHHH9AAAAYAAAAAAAAAAAAAAA:HHHHHHHHHHHH9AAAAAAA:HHHHHHHHOY
VHHHHHHHHHHHH9AAYAAAAAAAAAAAAA:HHHHHHHHHHHHHHH9AAAAA:HHHHHHHHHOY
VHHMQRVHHHHHSQRAYAAAAAAA:HHHHHHHHHHHHHHHHHHHHHHH9A:HHHHHHHHHHHOY
VHHOST:HHHHH9STAYAAAAA:HHHHHHHHHHHHHHHHHHHHHHHHHHHHHHHHHHHHHHHOY
VHHOWVHHHHHHH9ABYAAA:HHHHHHHH;AYYTHHHHHHHHHHHHHHHHHHHHHHHHHHHHOY
VHHOWVHHHHHHHHAAYAAAHHHHHH?@H9AAWVHHHHHHHHHHHHHHHHHHHHHHHHHHHHOY
VHHOWVGGGGGGHH9AAAA:H?@HHHHHHHHAWYVHHHHHHHHHHHHHHHHHHHHHHHHHHHOY
VHHOWYYYYYYVHHWYYYAHHHHHHHHHHHH9AA:HHHHHHHHHHHHHHHHHHHHHHHHHHHOY
VHHOSVHHHHHHHH9AAAA<HHHHHHHHHHHHHHHHHHHHWVHHHHHHHHHHHHHHHHHHHHOY
VHHOWVHHHHHHHHHH?BA@HHHHHHHHHHHHHHHAHHHHWVHHHHHWYYYYYVHHHHHHHHOY
VHHOWVHHHHHHHHHH9AA@HHHHHHHHHHHHHHHHHHHHHHHHHHGGGGGGGGGHHHHHHHOY
VHHOWVGGGGGGGGGGGoooGGHHHHHHHHHHWVHHHHHHHHHHHHWYYYYYYYVHHHHHHWNY
VMWYYYYYYYYYYYYYYYYYYVGGGGGGGGGGGGGGGGGGGGGGGGWYYYYYYYVGGGGGG9YY
VOAAAAAAAAAAAAAAAAAAAWYYYYYYYYYYYYYYYYYYYYYYYYYYYYYYYYYYYYYYYYYY
VOAAAAAAAAAAAAAAAAAAAAAAAAAAWYYYYYYYYYYVejjjjjihhhhhhhhhimHHHHHH
VOAAAAAAAAAAAAAAAAAAAAAAAAAAABAAAAAA:HOHHOHOHH9AAAAAAAAAehhhhimH
VOAAAAAABAAAAAAAAAAAAAAAAAAAAAAAA:HHHHOHHOHOHHHH9AABAAAA:HHHHehm
VNAAAAA:9AAAAAAAAAABAAAAAAAAA:HHHHHHHHOHHNHOHHHHHAAAAAAAHHHHHHea
VAAAA:HWYYYYYYYYYAAAAAAA:WYMHHHHHHHHHHOHHHHNHHHH;AAAAAA:HHHHHHHc
VAA:HHHHH9AAAAAAAAAA:HHHHH9OHHHHHHH_]`OHHHHHHHHH3AAAAA:HHHHHHHHa
V:HHHHHHHHH9AAAA:HHHHHHHHHHOHHHHHH_kHdNHHHHHHHHHAAAAA8HHHHHHHHHc
VHHHGHHHHHHHAAAAHHHHHHHHHHHOHHHH_[kHHbHHHHHHHHH;ABAAA6HHHHHHHHHc
VHHHYHHHHHHH912:HHHHHHHHHHHOHHH_kHHHHbHHHHHHHHH_\\\\\\\`MHHHHHHc
VHHHYHHHHHHHH?@HHHHHHHHHHHHOH_\kHHHHHdHHHHHHHH_kHHHHHHHdOHHHHHHa
VHHGYGHHHHHHH?@HHHHHHHHHHHHOHaHHHHHHHbHHHHHHH_kHHHHHHHHbOHHHHHHc
VHHWYVHHHHHHH?@HHHHHHHHHHHHO_kHHHHHHHdHHHH_]]kHHHHHHHHHdOHHHHHHa
VHHWYVHHHHHHH?@HHHHHHHHHHHHOcHHHHHHHHbHHHHaHHHHHHHHHHHnfOHHHHH_k
VGGWYVGGGGGG;AA<HHHHHHHHHHHOcHHHHHHHHbHHH_kHHHHHHHHHHnfHOHHHHHcH
YYYYYYYYYYYYYYYYYYYYYYYV_\[^kHHHHHHHHl^`HaHHHHHHHHHnjfHHNHHHHHaH
HHHHHHHHHHHHHHHHHHHHHHHHkHHHHHHHHHHHHHHl^kHHHHHHHnhfHHHHHHHHHHcH
HHHHHHHHHHHHHHHHHHHHHHHHHHHHHHHHHHHHHHHHHHHHHHHHHdAA<HHHHHHH_\kH
HHHHHHHHHHHHHHHHHHHHHHHHHHHHHHHHHHHHHHHHHHHHHHHHnfAAAA<HHHHHaHHH
ijhjhjihjiiijhijhihggjigjjhjggjijjhjhiggjjhjhjgjfAAAAAAA<=>_kHHH
AAABAAAAAAAAAAAAAAAAAAAAAABAAAAAAAAAAAAAABAAAAAAAAAAAAAAAA_kHHHH
AAAAAA:9ABAAAA:9AAABAA:9AAAAAA:9AAAABA:9AAAAAA:9AAAAAA:9AAaHHHHH
H912:HHHH912:HHHH912:HHHH912:HHHH912:HHHH912:HHHH912:HHHH_kHHHHH
HH34HHHHHH34HHHHHH34HHHHHH34HHHHHH34HHHHHH34HHHHHH34HHHHHcHHHHHH
HH78HH12HH76HH12HH76HH12HH76HH12HH76HH12HH76HH12HH76HHM_^kHHHHHH
<H76H;AA<H76H;AA<H56H;AA<H76H;AA<H76H;AA<QR6H;AA<H76H;OaHHHHHHHH
AAAAAA:9AAAAAA:9AAAAAA:9AAAAAA:9AAAAAA:9ASTAAA:9AAAAAAOaHHHHHHHH
H9AA:HHHH9AA:HHHH9AA:HHHH9AA:HHHH9AQRHHHHWVA:HHHH9AA:HOcHHHHHHHH
HH76HHHHHH76HHHHHH76HHHHHQR8HHHHHH7STHHHHSV6HHHHHH76HHOemHHHHHHH
HH56HHHHHH76HHHHHH76QRHHHST6HHHHHH7SQRHHHSYYYYYYYYYYYYYVcHHHHHHH
HH?@HHHHHH5@HHHHHH?6SVHHHSQRHHHHHH?SYTHHHSYYVAAAAA:HHHH9emHHHHHH
H;AA<HHHH;AA<HHHH;AASVGGGSYT<HHHH;ASYVHHHSYVAAAA:HHHHHHH9emHHHHH
YYYYYYYYYYYYYYYYYYYYYYYYYYYYYYYYYYYYYYYYYYVAAA:HHHHHHHHHH9eHHHHH
